16 8
XXXXXXXXXXXXXXXX
X X XXXXXXXXXX*X
X$X XX     XXX X
X X XX XXX XXX X
X   XX XXX XXX X
XXX X   XX XXX X
XXX   X        X
XXXXXXXXXXXXXXXX